111111111111111111111
130222222202222222001
101212121212121212101
122222222202222222221
121212121212121212121
122222222202222222221
121212101212101212121
122222000222000222221
121212101212101212121
122222222222222222221
101010121212121010101
122222222222222222221
121212101212101212121
122222000222000222221
121212101212101212121
122222222202222222221
121212121212121212121
122222222202222222221
101212121212121212101
100222222202222222031
111111111111111111111